[[  0,  0,  0,  0,  0,  0,  0,  0,  0,  0],
 [  0,  0,  0,  0,  0,  0,  0,  0,  0,  0],
 [  0,  0,  0,  0,  0,  0,  0,  0,  0,  0],
 [  0,  0,  0,  0,  0,  0,  0,  0,  0,  0],
 [  0,  0,  0,201,  1,301,  0,  0,  0,  0],
 [  0,  0,  0,  0,  0,  0,  0,  0,  0,  0],
 [  0,  0,  0,  0,  0,  0,  0,  0,  0,  0],
 [  0,  0,  0,  0,  0,  0,  0,  0,  0,  0],
 [  0,  0,  0,  0,  0,  0,  0,  0,  0,  0],
 [  0,  0,  0,  0,  0,  0,  0,  0,  0,  0]]
 

[[  0,  0,  0,  0,  0,  0,  0,  0,  0,  0],
 [  0,  0,  0,  0,  0,  0,  0,  0,  0,  0],
 [  0,  0,  0,  0,  0,  0,  0,  0,  0,  0],
 [  0,  0,  0,  0,302,  0,  0,  0,  0,  0],
 [  0,  0,  0,201,  1,  0,  0,  0,  0,  0],
 [  0,  0,  0,  0,  0,  0,  0,  0,  0,  0],
 [  0,  0,  0,  0,  0,  0,  0,  0,  0,  0],
 [  0,  0,  0,  0,  0,  0,  0,  0,  0,  0],
 [  0,  0,  0,  0,  0,  0,  0,  0,  0,  0],
 [  0,  0,  0,  0,  0,  0,  0,  0,  0,  0]],
 

[[  0,  0,  0,  0,  0,  0,  0,  0,  0,  0],
 [  0,  0,  0,  0,  0,  0,  0,  0,  0,  0],
 [  0,  0,  1,  1,  1,  1,  1,  0,  0,  0],
 [  0,  0,  1,  1,  1,  1,  1,  0,  0,  0],
 [  0,  0,201,  1, 11,  1,302,  0,  0,  0],
 [  0,  0,  1,  1,  1,  1,  1,  0,  0,  0],
 [  0,  0,  1,  1,  1,  1,  1,  0,  0,  0],
 [  0,  0,  0,  0,  0,  0,  0,  0,  0,  0],
 [  0,  0,  0,  0,  0,  0,  0,  0,  0,  0],
 [  0,  0,  0,  0,  0,  0,  0,  0,  0,  0]],
 
 
[[  0,  0,  0,  0,  0,  0,  0,  0,  0,  0],
 [  0,  0,  0,  0,  0,  0,  0,  0,  0,  0],
 [  0,  0,  1,  2,  1,  1,  2,  0,  0,  0],
 [  0,  0,  1,  1,  1,  1,203,  0,  0,  0],
 [  0,  0,  1, 11, 12, 13, 11,  0,  0,  0],
 [  0,  0,  1,  2,  1,  1,301,  0,  0,  0],
 [  0,  0,  1,  1,  1,  2,  1,  0,  0,  0],
 [  0,  0,  0,  0,  0,  0,  0,  0,  0,  0],
 [  0,  0,  0,  0,  0,  0,  0,  0,  0,  0],
 [  0,  0,  0,  0,  0,  0,  0,  0,  0,  0]],
 
 
[[  0,  0,  0,  0,  0,  0,  0,  0,  0,  0],
 [  0, 31, 31, 31, 31, 32, 31, 31,  0,  0],
 [  0, 31, 11,  1,  1,  1,  2, 33,  0,  0],
 [  0, 31,  1,  2,  1,  1,203, 34,  0,  0],
 [  0, 31,  1, 11, 12, 13, 11, 31,  0,  0],
 [  0, 32,  1,  2,  1,  1,301, 31,  0,  0],
 [  0, 31,  1,  1,  2,  2,  1, 31,  0,  0],
 [  0, 33, 31, 31, 31, 31, 31, 31,  0,  0],
 [  0,  0,  0,  0,  0,  0,  0,  0,  0,  0],
 [  0,  0,  0,  0,  0,  0,  0,  0,  0,  0]],
 
 
[[ 12, 11, 11, 12, 12, 11, 11, 12, 12, 11],
 [ 11, 11, 11, 11, 11, 12, 12, 11, 11, 12],
 [  1,  1,  1,  1,  2,  2,  1,  1,  1,  1],
 [  1,  1,  1,  2,  1,  1,  1,  1,  2,  1],
 [301,  1,  1,  1,  2,  1,  1,  1,  1,203],
 [  1,  2,  1,  2,  1,  1,  2,  2,  1,  1],
 [  1,  1,  1,  1,  2,  2,  1,  1,  1,  1],
 [ 32, 32, 31, 31, 31, 31, 31, 31, 31, 31],
 [ 31, 31, 31, 31, 31, 31, 31, 31, 33, 34],
 [ 31, 31, 31, 31, 31, 31, 31, 33, 34, 33]],
 

[[ 31, 32, 11, 12, 11, 13, 12, 12, 11, 11],
 [ 31, 31,  1,  1,  2,  1,  1,  1,  1,  2],
 [ 32,  1,  1,  1,  2,  2,  1,  1,  1,  1],
 [ 31,  1,  1,301,  1,301,  1,202,  2,  1],
 [ 11,  1,  1,  1, 12,  1, 12,  1,  1,  2],
 [  1,  2,  1,301,  1,302,  1,302,  1,  1],
 [ 11,  1,  1,  1, 12,  1, 12,  1,  1,  1],
 [  1,  2,  1,302,  1,301,  1,301,  1,  2],
 [ 12,  2,  2,  2,  1,  1,  1,  1,  1,  1],
 [ 12,  2,  1,  1,  1,  1,  1,  1,  2,  1]],
 
 
[[ 13, 13,  1, 12, 11, 13, 12, 12, 11, 11],
 [  1,  1,  1,  1,  2,  1,  1,  1,  1,  2],
 [  2,  1,  1,  1,  2,  2,  1,  1,  1,  1],
 [  1,  1,  1, 11, 12, 11, 12, 11, 11,  1],
 [ 11,  1,  1,401,  2,  1,  2,  1,203,  2],
 [  1,  2, 11, 12,  1, 12, 12, 12, 12,  1],
 [ 11,  1,301,  1,  2,  1,  2,  1,302,  1],
 [  1,  2,  1,  2,  1,  1,  1,  1,  1,  2],
 [ 12,  2,  2,  2,  1,  1,  1,  1,  1, 31],
 [ 12,  2,  1,  1,  1,  1,  1,  1, 33, 31]],
 
 
[[ 31, 31, 31, 31,  1,  1,  1,  1, 34, 31],
 [ 32,  1,  1,  1,  2,  1,  1,  1, 33, 33],
 [  2,  1,  1,  1,202,  2,  1,  1, 31, 31],
 [  1,  1,  1,  1,  1,  1,  1,  1,  1,  1],
 [  1,  1,  1,  2,  2,  1,  2,  1,  2,  2],
 [ 41,401,  1,  1,  1,  1,  2,  1,  1, 41],
 [  1,  1,  1,  1,  2,  1,  2,  1,  2,  1],
 [  1,  2,  1,  2,302,  1,  1, 31, 31, 31],
 [ 31,  2,  2,  2,  1,  1, 31, 31, 31, 31],
 [ 31, 33, 31,  1,  1,  1, 31, 31, 33, 31]],