[[  0,  0,  0,  0,  0,  0,  0,  0,  0,  0],
 [  0,  0,  0,  0,  0,  0,  0,  0,  0,  0],
 [  0,  0,  0,  0,  0,  0,  0,  0,  0,  0],
 [  0,  0,  0,  0,  0,  0,  0,  0,  0,  0],
 [  0,  0,  0,201,  1,301,  0,  0,  0,  0],
 [  0,  0,  0,  0,  0,  0,  0,  0,  0,  0],
 [  0,  0,  0,  0,  0,  0,  0,  0,  0,  0],
 [  0,  0,  0,  0,  0,  0,  0,  0,  0,  0],
 [  0,  0,  0,  0,  0,  0,  0,  0,  0,  0],
 [  0,  0,  0,  0,  0,  0,  0,  0,  0,  0]]
 

[[  0,  0,  0,  0,  0,  0,  0,  0,  0,  0],
 [  0,  0,  0,  0,  0,  0,  0,  0,  0,  0],
 [  0,  0,  0,  0,  0,  0,  0,  0,  0,  0],
 [  0,  0,  0,  0,302,  0,  0,  0,  0,  0],
 [  0,  0,  0,201,  1,  0,  0,  0,  0,  0],
 [  0,  0,  0,  0,  0,  0,  0,  0,  0,  0],
 [  0,  0,  0,  0,  0,  0,  0,  0,  0,  0],
 [  0,  0,  0,  0,  0,  0,  0,  0,  0,  0],
 [  0,  0,  0,  0,  0,  0,  0,  0,  0,  0],
 [  0,  0,  0,  0,  0,  0,  0,  0,  0,  0]]
 

[[  0,  0,  0,  0,  0,  0,  0,  0,  0,  0],
 [  0,  0,  0,  0,  0,  0,  0,  0,  0,  0],
 [  0,  0,  1,  1,  1,  1,  1,  0,  0,  0],
 [  0,  0,  1,  1,  1,  1,  1,  0,  0,  0],
 [  0,  0,201,  1, 11,  1,302,  0,  0,  0],
 [  0,  0,  1,  1,  1,  1,  1,  0,  0,  0],
 [  0,  0,  1,  1,  1,  1,  1,  0,  0,  0],
 [  0,  0,  0,  0,  0,  0,  0,  0,  0,  0],
 [  0,  0,  0,  0,  0,  0,  0,  0,  0,  0],
 [  0,  0,  0,  0,  0,  0,  0,  0,  0,  0]]
 
 
[[  0,  0,  0,  0,  0,  0,  0,  0,  0,  0],
 [  0,  0,  0,  0,  0,  0,  0,  0,  0,  0],
 [  0,  0,  7,  2,  1,  1,  2,  0,  0,  0],
 [  0,  0,  1,  1,  1,  1,203,  0,  0,  0],
 [  0,  0,  1, 14, 12, 13, 11,  0,  0,  0],
 [  0,  0,  1,  2,  1,  1,301,  0,  0,  0],
 [  0,  0,  3,  1,  1,  2,  1,  0,  0,  0],
 [  0,  0,  0,  0,  0,  0,  0,  0,  0,  0],
 [  0,  0,  0,  0,  0,  0,  0,  0,  0,  0],
 [  0,  0,  0,  0,  0,  0,  0,  0,  0,  0]]
 
 
[[  0,  0,  0,  0,  0,  0,  0,  0,  0,  0],
 [  0, 31, 35, 31, 36, 35, 31, 31,  0,  0],
 [  0, 31, 11,  1,  1,  1,  2, 33,  0,  0],
 [  0, 31,  1,  2,  1,  1,203, 34,  0,  0],
 [  0, 31,  1, 11, 12, 13, 11, 31,  0,  0],
 [  0, 32,  1,  2,  1,  1,301, 31,  0,  0],
 [  0, 31,  1,  1,  2,  2,  1, 31,  0,  0],
 [  0, 33, 31, 37, 31, 35, 31, 33,  0,  0],
 [  0,  0,  0,  0,  0,  0,  0,  0,  0,  0],
 [  0,  0,  0,  0,  0,  0,  0,  0,  0,  0]]
 
 
[[ 12, 11, 11, 12, 12, 11, 11, 12, 12, 11],
 [ 11, 11, 11, 11, 11, 12, 12, 11, 11, 12],
 [  6,  1,  7,  1,  2,  3,  1,  1,  1,  1],
 [  1,  1,  1,  2,  1,  1,  1,  1,  2,  1],
 [301,  1,  1,  1,  2,  1,  1,  1,  7,203],
 [  1,  2,  3,  2,  1,  1,  2,  6,  1,  1],
 [  1,  7,  1,  1,  2,  2,  1,  1,  7,  1],
 [ 32, 36, 31, 31, 31, 35, 31, 31, 31, 31],
 [ 31, 31, 31, 35, 31, 31, 31, 31, 33, 34],
 [ 31, 31, 31, 31, 35, 31, 31, 33, 37, 33]]
 

[[ 37, 32, 11, 12, 14, 13, 12, 12, 11, 14],
 [ 31, 35,  1,  1,  2,  1,  1,  1,  1,  2],
 [ 32,  1,  1,  1,  2,  2,  1,  1,  7,  1],
 [ 31,  3,  1,301,  1,301,  1,202,  2,  1],
 [ 11,  1,  1,  1, 12,  1, 12,  1,  1,  2],
 [  1,  2,  1,301,  1,302,  1,302,  7,  1],
 [ 11,  1,  1,  1, 12,  1, 12,  1,  1,  1],
 [  1,  2,  1,302,  1,301,  1,301,  1,  2],
 [ 14,  2,  6,  2,  1,  1,  6,  7,  1,  1],
 [ 12,  2,  1,  1,  7,  1,  1,  1,  2,  1]]
 
 
[[ 13, 14,  1, 12, 11, 13, 12, 12, 11, 11],
 [  1,  1,  1,  1,  2,  1,  1,  6,  1,  2],
 [  2,  7,  1,  1,  2,  2,  1,  1,  7,  1],
 [  1,  1,  1, 11, 12, 11, 12, 11, 11,  1],
 [ 11,  1,  1,401,  2,  1,  2,  1,203,  2],
 [  1,  2, 11, 12,  1, 12, 12, 12, 12,  1],
 [ 11,  1,301,  1,  2,  6,  2,  1,302,  1],
 [  1,  2,  1,  2,  1,  1,  1,  6,  1,  2],
 [ 12,  7,  2,  2,  3,  1,  7,  1,  1, 33],
 [ 12,  2,  1,  1,  1,  1,  1,  1, 35, 31]]
 
 
[[ 31, 31, 36, 34,  1,  1,  1,  7, 34, 31],
 [ 32,  1,  1,  1,  2,  1,  1,  1, 33, 37],
 [  2,  1,  1,  1,202,  2,  1,  1, 31, 31],
 [  1,  3,  1,  6,  1,  1,  1,  7,  1,  1],
 [  1,  1,  1,  2,  2,  1,  2,  1,  2,  2],
 [ 41,401,  1,  1,  1,  3,  2,  1,  1, 41],
 [  1,  7,  1,  1,  2,  1,  2,  6,  2,  1],
 [  1,  2,  1,  2,302,  1,  1, 31, 31, 31],
 [ 31,  2,  2,  2,  1,  1, 33, 31, 31, 35],
 [ 31, 33, 31,  1,  1,  1, 31, 32, 33, 31]]
 
 
[[ 11, 12,  43,  1,  1,  1,  1,  1,  5,301],
 [ 51, 42,  2,  1,  2,  1,  1,302,301,302],
 [ 52,  1,  1,  1,  2,  2,  4,302,  4,  1],
 [ 53, 11,  1,  1,  1,301,301,302,  1,  1],
 [ 51,  1,  1,  2,  4,302,  5,  1,  2,  2],
 [ 51,  1,  1,301,302,302,  2,  1,  1,  1],
 [ 52,  1,  5,301,  4,  1,  2,  1,  2,  1],
 [ 51,302,301,302,  1,  1,  1,  1,  1, 33],
 [  4,302,  5,  2,  1,  1,  1,  1, 34, 33],
 [201,301,  1,  1,  1,  1,  1, 31, 31, 31]]
 
 
[[302,  1,  1, 11, 12, 11, 11,  6,  1,302],
 [  1, 31,  1,  2,  6,  1,  1,  1, 31,  1],
 [  2,  1, 32, 32, 34, 31, 31, 35,202,  1],
 [ 11,  7, 31, 31, 31, 31, 31, 35,  1, 11],
 [ 12,  1, 31, 31,  2,402, 31, 31,  6, 11],
 [ 12,  3, 31, 35, 41,  7, 31, 32,  1, 12],
 [ 11,  1, 36, 31, 31, 31, 31, 34,  7, 12],
 [  2,  1, 31, 31, 31, 32, 31, 33,  1,  1],
 [  1, 32,  1,  2,  7,  1,  1,  1, 33,  1],
 [301,  1,  1, 12, 12, 12, 13,  1,  7,301]]
 
 
[[  1,302,  1,302,  1,301,  1,302,  1,301],
 [302,  2,302,  6,301,  1,302,  6,301,  1],
 [  1,302,  2,302,  1,302,  1,301,  7,302],
 [302,  1,302,  2,302,  2,302,  1,301,  1],
 [  1,302,  2,302,  1,301,  3,301,  2,302],
 [302,  1,301,  7,301,  2,302,  1,302,  1],
 [  1,302,  2,302,  3,301,  3,302,  2,302],
 [302,  1,302,  1,301,  1,302,  1,302,  1],
 [  2,301,  6,301,  1,302,  1,301,  2,302],
 [201,  1,301,  1,302,  1,302,  2,302,  2]]